1,1,1,1,1,1,1,1,1,1,1,1,1,1,1,1,1,1,1,1,1,1,1,1,1,1,1,1,1,1,1,1,1,1,1,1,1,1,1,1,1,1,1,1,1,1,1,1,1,1,1
1,0,0,0,0,0,5,0,0,1,1,0,0,0,8,0,2,0,8,0,0,0,0,0,0,0,0,0,0,0,0,0,0,4,0,1,0,7,0,0,0,0,0,0,0,0,8,0,2,1,1
1,0,0,0,0,9,6,0,0,1,1,0,0,0,0,0,0,8,0,0,0,0,6,0,5,0,0,9,0,0,0,0,0,0,0,1,0,0,0,0,0,0,0,0,0,0,0,0,0,1,1
1,0,0,0,0,0,0,0,0,1,1,0,0,0,6,0,0,0,0,7,2,0,0,0,0,0,0,2,0,0,0,0,0,0,1,1,0,0,0,0,0,0,0,0,0,0,0,0,0,1,1
1,0,2,0,1,1,0,0,2,1,1,0,0,0,1,1,0,0,0,1,1,1,1,1,1,1,0,0,0,1,1,1,1,1,1,1,0,0,0,1,1,1,1,1,1,1,0,0,0,1,1
1,0,0,0,1,1,0,0,0,1,1,0,0,0,1,1,0,0,0,1,1,1,1,1,1,1,0,0,0,1,1,1,1,1,1,1,0,0,0,1,1,1,1,1,1,1,7,0,0,1,1
1,6,0,0,0,0,0,0,0,1,1,0,0,0,1,1,0,0,7,0,0,7,0,0,1,1,0,0,0,1,1,0,0,0,0,0,8,8,0,7,0,0,0,0,1,1,0,0,0,1,1
1,0,0,5,0,0,0,0,0,1,1,0,0,0,1,1,0,0,0,0,0,6,6,0,1,1,0,0,0,1,1,0,0,0,0,0,0,0,0,0,0,0,0,0,1,1,0,0,0,1,1
1,0,7,0,0,0,0,8,0,1,1,0,0,0,1,1,0,0,0,0,8,0,0,0,1,1,8,0,0,1,1,0,0,7,0,0,0,0,0,0,2,0,0,0,1,1,0,0,0,1,1
1,0,0,0,1,1,0,0,0,1,1,1,1,1,1,1,1,1,1,1,1,0,0,0,1,1,1,1,1,1,1,0,0,0,1,1,1,1,1,1,1,1,1,1,1,1,0,0,0,1,1
1,0,0,5,1,1,9,0,0,1,1,1,1,1,1,1,1,1,1,1,1,0,0,0,1,1,1,1,1,1,1,0,0,0,1,1,1,1,1,1,1,1,1,1,1,1,0,0,0,1,1
1,0,7,0,0,0,0,0,0,0,0,0,0,0,0,0,7,0,0,1,1,0,0,0,8,0,0,0,0,0,0,0,7,0,0,0,0,0,5,1,1,0,0,0,0,0,0,0,6,1,1
1,0,0,0,8,0,0,0,6,0,0,7,0,2,0,0,7,0,0,1,1,0,0,7,0,0,0,0,0,0,0,0,0,0,0,0,8,0,8,1,1,0,0,0,2,9,0,8,0,1,1
1,7,8,0,0,0,0,8,0,0,0,0,0,8,0,0,0,0,0,1,1,0,7,2,8,0,0,8,0,0,8,0,0,0,0,0,0,0,0,1,1,0,8,0,0,0,2,0,0,1,1
1,2,0,0,1,1,1,1,1,1,1,1,1,1,1,1,0,0,0,1,1,1,1,1,1,1,1,1,1,1,1,1,1,1,1,1,0,0,0,1,1,0,0,0,1,1,5,0,0,1,1
1,0,0,9,1,1,1,1,1,1,1,1,1,1,1,1,0,0,0,1,1,1,1,1,1,1,1,1,1,1,1,1,1,1,1,1,0,7,0,1,1,0,0,2,1,1,0,6,0,1,1
1,0,0,0,0,0,0,0,0,0,0,6,0,5,1,1,0,0,5,6,0,0,0,0,0,0,8,8,0,1,1,0,0,7,1,1,0,0,0,1,1,5,0,5,1,1,0,0,0,1,1
1,0,0,0,0,0,0,3,0,0,0,0,7,0,1,1,0,0,7,0,0,0,0,7,0,0,7,7,0,1,1,0,0,2,1,1,0,0,8,1,1,9,0,0,1,1,0,0,6,1,1
1,0,0,2,0,0,0,0,0,0,0,0,0,0,1,1,0,0,0,0,0,0,0,0,8,0,0,0,0,1,1,0,0,0,1,1,0,0,6,1,1,0,0,0,1,1,0,0,0,1,1
1,0,6,0,1,1,1,1,1,1,1,0,0,2,1,1,1,1,1,1,1,1,1,1,1,1,6,0,0,1,1,7,0,0,1,1,0,0,6,1,1,0,0,0,1,1,1,1,1,1,1
1,0,2,0,1,1,1,1,1,1,1,7,8,0,1,1,1,1,1,1,1,1,1,1,1,1,0,0,0,1,1,0,0,0,1,1,0,0,9,1,1,8,0,0,1,1,1,1,1,1,1
1,8,0,0,0,0,0,0,0,1,1,0,0,0,1,1,0,0,0,0,0,0,0,0,0,0,6,0,0,1,1,0,0,0,0,0,2,0,0,1,1,0,8,0,0,0,0,6,0,1,1
1,0,0,0,0,0,0,0,0,1,1,0,0,0,1,1,0,0,0,0,8,0,0,0,0,0,9,0,0,1,1,0,0,0,0,0,0,0,0,1,1,0,0,9,8,8,0,0,2,1,1
1,0,0,5,0,0,0,0,7,1,1,0,0,9,1,1,0,6,0,0,2,0,0,0,0,0,0,0,0,1,1,0,0,8,7,0,0,0,0,1,1,0,5,0,0,0,7,0,0,1,1
1,6,0,2,1,1,0,0,0,1,1,0,0,0,1,1,0,0,0,1,1,1,1,1,1,1,1,1,1,1,1,0,5,0,1,1,1,1,1,1,1,1,1,1,1,1,0,0,0,1,1
1,6,0,0,1,1,2,0,0,1,1,0,0,0,1,1,0,0,0,1,1,1,1,1,1,1,1,1,1,1,1,0,8,0,1,1,1,1,1,1,1,1,1,1,1,1,0,0,0,1,1
1,7,0,2,0,8,8,0,0,1,1,0,0,0,1,1,0,0,0,1,1,0,0,0,0,0,0,0,0,0,0,0,0,0,1,1,0,0,0,0,0,0,0,0,1,1,0,0,0,1,1
1,7,0,0,0,0,0,0,0,1,1,0,0,0,1,1,0,0,0,1,1,2,0,0,0,0,0,6,0,2,0,0,0,0,1,1,2,0,0,0,0,0,0,6,1,1,0,5,0,1,1
1,0,0,0,0,0,0,0,0,1,1,0,5,0,1,1,0,0,0,1,1,0,0,0,0,0,0,0,8,0,0,0,0,0,1,1,5,7,0,0,2,0,0,7,1,1,0,0,0,1,1
1,0,0,0,1,1,1,1,1,1,1,0,8,0,1,1,0,0,0,1,1,1,1,1,1,1,1,1,1,1,1,1,1,1,1,1,0,8,6,1,1,0,0,0,1,1,0,8,0,1,1
1,6,0,0,1,1,1,1,1,1,1,0,0,0,1,1,0,0,0,1,1,1,1,1,1,1,1,1,1,1,1,1,1,1,1,1,2,0,0,1,1,0,0,0,1,1,2,0,0,1,1
1,0,0,0,5,0,0,0,0,0,0,6,0,0,1,1,0,0,5,0,0,0,0,8,0,0,0,8,0,0,0,0,0,0,2,0,0,0,0,0,0,0,0,0,0,0,0,0,0,1,1
1,0,6,0,0,0,0,0,8,0,0,0,0,0,1,1,0,0,0,6,0,7,0,0,0,0,0,0,7,8,0,6,6,0,0,0,0,0,0,6,6,0,0,0,0,0,0,0,0,1,1
1,0,2,0,0,0,0,0,0,5,0,0,0,8,1,1,0,0,0,0,0,0,0,8,0,0,0,0,0,0,0,0,8,0,0,0,0,0,9,0,0,0,0,0,0,0,0,0,0,1,1
1,1,1,1,1,1,1,1,1,1,1,1,1,1,1,1,1,1,1,1,1,1,1,1,1,1,1,1,1,1,1,1,1,1,1,1,1,1,1,1,1,1,1,1,1,1,1,1,1,1,1
1,1,1,1,1,1,1,1,1,1,1,1,1,1,1,1,1,1,1,1,1,1,1,1,1,1,1,1,1,1,1,1,1,1,1,1,1,1,1,1,1,1,1,1,1,1,1,1,1,1,1
1,1,1,1,1,1,1,1,1,1,1,1,1,1,1,1,1,1,1,1,1,1,1,1,1,1,1,1,1,1,1,1,1,1,1,1,1,1,1,1,1,1,1,1,1,1,1,1,1,1,1
1,1,1,1,1,1,1,1,1,1,1,1,1,1,1,1,1,1,1,1,1,1,1,1,1,1,1,1,1,1,1,1,1,1,1,1,1,1,1,1,1,1,1,1,1,1,1,1,1,1,1
