111111111111111111111111111111111111111111111111111
100000000006000007000000106000100000000000201000901
101110111111111010111011101115101010111110101010111
100010001000101818101000101510101010100815101010601
101810101010101016101110101010101010121110111011151
181010001010001010081010261010621008101026000000101
101010111711111011101011111011111111101811161111101
100009171000601600100710000000100000601000001010601
101119101011101118111011101110111011181111111016101
100010100050170606101000121010000012171000001910101
101110101119111111171110101011111110101011101010171
101600000000001050000210101006002500106710100919101
111211111111101011111010101110111111161110111010111
102010000200061065501000100810081500671700102010061
101110111110121110101110111011101011181010101110101
101070100010100618100010002010001000100010221000101
101110101011111010111011101010111112111111181117101
100010001050901010501000100610080000201809101000101
100000111110111011101110111111111111111010101018101
100300060010100015871000001070020080100010100010101
100001111816181110111111101211111119101110111811101
100010000500151005100010185010050010100010501010001
101010111511101010101012111110111610101010101010101
101000100210001010101010850010001800106715061010101
171111111010111010101010111111101111101619111110101
100000001017100210000010000000801000201010600000101
101111101010111111111010111111111011111011111111101
100000101010100007008210001000005010000810000570601
111118101110151111111110171010111110151110111110111
101000166010101000002017101010100010102018150010021
101011111010101511111010101017101015111010151011101
101007001005160000001710100010261000169010001000101
101110161111101011101010111110101111101111111110101
108010901006000010151015600070100000180000100010001
101011101110111010101110111111101110111100001011101
100000000005100000108000605720005000000004001800071
111111111111111111111111111111111111111100011111111
111111111111111111111111111111111111111111111111111
