111111111111111111111111111111111111111111111111111
100000090010001000001000000000661000001220000010001
161011111110191011191010111111101010101111101010111
191000100000170070101215100500001010100007061017001
101115101111111110101017111112111110111111111011101
101010001000001006001010602010100000100610629010001
101011111111101011111011111512111011101110111110101
100000020000001010000010001010100010007010101000101
111111111111101010111110101010101110111010101010111
100022001002051510901010100019001022101000100010051
101110111211111011101010111111111011101111101111101
100010100010901500200610001002001050000900151007101
111110101110111111101111101211101011111010161110101
100000161000106000101000001000121000001910106000101
101111121110101110111011111111101111161210111110101
101000001000100010001210600097000510101016001060121
101011111012111011101010101111111017151110111211171
100000000610201900150712101200000000100010000017091
100001111111111110111111101111111110111015111110111
100300000010250000100020100000100019901010000010601
100001111210111111101110121010101011111011101111161
100000000015057010001000100010001200202010091000101
101111111111111010111011111111111011111110111212101
100000000010001010761900100710061710001000100010201
111111111010101711101116101010101011151011101111101
151000090010101007070015001010121000150010001000001
101011111110101111111110111010101110101110111011111
101200160200100012000910901070101610100010101010701
101110101111111010111011111211101010111110151010151
100010160600101000101610061007101000200010171600101
111010111010101011101019101110101111111010101111101
100010001000100600071000101000120000001052150010001
161111121011111110111111101111111111101111101110111
101000100016002902120502100000001600001000000012061
101219111010111111191011111111101011111011000011101
100010700000500000001000900090005510290600040000071
111111111111111111111111111111111111111111000111111
111111111111111111111111111111111111111111111111111
