1,1,1,1,1,1,1,1,1,1,1,1,1,1,1,1,1,1,1,1,1,1,1,1,1,1,1,1,1,1,1,1,1,1,1,1,1,1,1,1,1,1,1,1,1,1,1,1,1,1,1
1,0,0,0,0,0,7,0,0,0,5,0,0,0,7,0,6,0,0,6,5,0,0,9,0,0,7,0,0,0,0,0,0,0,0,0,6,9,0,0,0,7,0,0,0,0,6,0,0,0,1
1,0,0,0,0,0,0,0,0,0,6,0,0,0,0,1,1,1,1,0,0,0,0,0,0,0,0,7,0,0,0,0,0,0,5,6,9,0,7,0,7,0,0,0,0,9,0,0,0,7,1
1,0,0,3,0,0,0,0,0,0,0,0,0,0,6,1,1,1,1,0,6,6,9,0,2,0,0,0,9,0,0,0,2,0,0,7,0,7,5,0,0,7,0,7,0,0,0,5,0,0,1
1,0,0,0,0,0,9,7,0,0,0,0,0,0,8,0,0,0,7,0,0,0,0,9,0,0,2,7,5,0,0,0,0,0,0,9,7,0,0,0,1,1,8,0,5,0,0,0,0,0,1
1,0,0,0,0,0,8,0,0,0,0,7,0,0,0,0,0,0,0,9,0,0,0,0,0,0,0,0,0,0,5,0,0,9,0,9,7,0,0,0,1,1,0,0,7,0,9,9,0,7,1
1,0,0,5,2,1,1,1,1,7,0,5,0,0,0,0,0,8,0,0,2,0,2,0,5,0,0,0,5,0,5,5,0,0,9,0,0,0,0,0,9,0,8,0,0,9,0,0,0,0,1
1,2,0,0,9,1,1,1,1,0,0,7,8,0,0,2,9,0,0,0,6,0,0,0,0,0,5,0,0,0,7,5,0,2,0,0,0,5,0,0,6,5,9,0,0,0,0,0,0,0,1
1,2,0,0,9,0,0,0,0,0,0,0,0,1,1,1,1,0,8,0,0,0,0,0,0,0,0,1,1,1,1,0,0,9,2,0,0,0,0,6,0,9,9,0,0,7,9,0,8,0,1
1,0,0,0,0,6,0,5,0,0,0,0,0,1,1,1,1,0,5,0,7,0,0,0,0,0,0,1,1,1,1,7,0,0,0,0,0,0,0,7,0,0,0,0,0,0,0,7,0,0,1
1,0,9,0,0,0,0,0,0,0,0,0,0,1,1,1,1,0,0,0,0,0,0,0,0,0,7,0,0,0,9,2,0,0,0,0,0,0,9,0,0,6,0,0,7,0,0,0,6,7,1
1,0,0,7,0,9,0,9,0,0,0,0,5,0,0,7,0,0,0,5,0,5,0,0,0,0,7,7,0,0,6,5,0,0,0,7,0,0,0,2,0,0,0,0,0,6,0,0,0,0,1
1,0,0,0,2,9,0,0,0,5,9,0,0,0,7,9,0,0,0,9,0,5,8,0,0,9,0,0,0,0,0,0,8,0,7,0,7,0,0,0,0,1,1,1,0,0,0,0,0,9,1
1,0,7,0,0,9,0,0,8,0,0,0,0,0,0,0,0,0,7,0,0,5,9,0,0,0,0,0,0,6,0,0,0,7,0,0,0,2,0,0,0,1,1,1,9,5,0,7,7,0,1
1,0,7,0,8,0,0,0,6,6,10,11,2,0,0,0,0,0,9,0,8,0,8,0,0,0,6,0,0,0,10,11,0,0,0,0,0,5,7,0,0,0,5,0,0,0,5,0,7,0,1
1,0,0,0,0,0,5,0,9,0,12,13,8,0,7,0,0,7,0,6,0,0,0,0,0,0,8,0,5,0,12,13,0,0,0,0,0,0,0,0,0,0,0,7,0,5,0,5,0,0,1
1,7,5,8,0,0,0,0,0,0,14,15,0,0,7,7,0,0,0,0,0,0,0,7,0,0,0,0,0,5,14,15,0,0,0,5,9,6,0,0,0,8,0,7,0,5,0,0,8,9,1
1,0,1,1,1,0,0,6,0,0,7,6,0,0,0,0,6,0,0,8,0,0,0,0,6,0,0,0,7,9,0,0,7,0,0,0,0,0,0,0,1,1,0,0,0,0,0,5,0,0,1
1,7,1,1,1,0,5,7,9,0,0,2,6,0,0,0,1,1,6,0,0,0,0,0,0,2,0,7,0,0,0,7,9,6,7,9,7,0,5,0,1,1,8,0,0,0,0,5,0,9,1
1,0,1,1,1,5,0,0,0,0,0,0,7,0,0,0,1,1,0,0,0,8,0,9,0,0,0,5,0,0,0,0,0,0,0,0,6,0,0,0,0,7,8,8,0,0,0,6,0,0,1
1,0,0,0,5,7,0,0,0,8,6,0,0,5,0,7,1,1,0,0,0,0,0,0,0,7,7,0,9,0,0,2,0,0,0,0,5,7,0,9,0,0,6,8,9,0,0,0,0,0,1
1,5,6,0,0,0,0,9,0,7,7,9,0,0,0,0,0,0,0,0,6,0,0,1,1,0,0,0,0,0,9,0,7,0,2,0,6,7,0,0,0,0,7,7,0,0,0,8,0,0,1
1,0,0,0,0,0,0,7,0,0,5,0,0,7,0,0,2,0,0,0,0,0,6,1,1,0,0,0,0,5,1,1,1,5,0,0,6,5,0,0,9,1,1,1,0,0,8,0,0,8,1
1,0,0,0,0,0,9,0,0,0,0,6,0,9,7,0,0,8,5,0,0,0,0,0,0,5,0,0,0,9,1,1,1,0,0,0,0,0,0,6,0,1,1,1,5,0,9,0,0,0,1
1,0,0,0,0,0,0,0,0,6,0,0,5,0,2,0,0,8,0,0,7,0,0,0,0,0,0,0,0,7,0,7,9,0,7,0,0,0,0,0,0,1,1,1,0,8,0,5,0,0,1
1,0,0,0,0,0,5,0,8,0,0,0,0,0,0,0,0,0,2,0,2,0,2,0,5,10,11,0,0,0,0,0,2,0,9,0,7,0,0,0,8,0,0,0,0,0,5,6,7,0,1
1,0,0,0,0,7,1,1,1,8,0,0,0,0,0,0,0,0,7,9,0,0,0,9,0,12,13,0,6,7,0,0,0,0,2,0,0,0,9,0,2,0,0,0,0,0,0,0,0,0,1
1,0,0,0,0,0,1,1,1,0,0,5,9,0,0,0,9,0,0,5,0,9,0,6,2,14,15,0,5,0,0,0,9,9,0,0,0,7,0,0,8,0,6,0,7,0,0,5,0,0,1
1,6,0,0,8,0,0,5,0,0,0,0,0,6,0,0,0,0,7,0,6,5,0,0,0,0,0,0,7,0,0,9,5,9,0,0,0,0,0,0,7,9,0,10,11,0,0,0,0,0,1
1,0,0,8,0,0,0,0,0,5,0,8,0,9,0,0,0,0,7,0,6,0,7,9,0,2,2,0,5,7,0,0,0,0,0,0,0,5,0,0,0,0,0,12,13,0,0,2,0,0,1
1,7,9,0,0,8,0,0,0,0,0,7,0,0,0,7,9,0,0,9,9,1,1,0,7,0,5,5,0,2,0,0,0,0,7,0,9,0,0,0,0,0,0,14,15,0,0,6,0,0,1
1,7,0,0,0,0,0,0,0,6,0,7,0,0,0,0,9,0,0,8,7,1,1,0,0,0,7,0,0,0,1,1,1,1,0,0,0,2,5,0,0,8,5,6,0,7,7,5,8,0,1
1,0,0,0,0,0,0,0,0,0,7,0,0,0,0,0,0,0,7,0,0,5,2,0,6,5,2,0,0,0,1,1,1,1,7,0,0,0,0,7,9,7,8,0,8,0,0,0,0,0,1
1,0,0,7,0,0,0,0,0,0,0,0,0,1,1,1,0,0,6,7,0,6,0,7,0,8,2,0,7,0,0,0,0,0,0,0,0,0,9,0,0,0,0,0,5,0,0,0,0,0,1
1,0,0,0,7,0,0,5,6,0,7,0,0,1,1,1,0,0,2,0,0,0,7,0,0,0,0,6,0,0,0,0,0,0,0,0,0,0,0,9,7,0,0,0,0,0,0,4,0,0,1
1,0,2,2,0,0,0,0,9,0,0,0,0,0,0,0,5,9,0,0,0,5,0,0,0,5,0,0,6,0,0,0,9,0,0,9,2,0,0,0,0,0,0,0,9,0,0,0,0,0,1
1,0,0,5,0,2,0,0,5,0,0,7,0,0,0,0,5,0,0,0,5,5,0,0,0,0,0,0,0,0,0,7,7,0,0,0,0,7,0,0,0,8,0,0,0,0,0,0,0,0,1
1,1,1,1,1,1,1,1,1,1,1,1,1,1,1,1,1,1,1,1,1,1,1,1,1,1,1,1,1,1,1,1,1,1,1,1,1,1,1,1,1,1,1,1,1,1,1,1,1,1,1