111111111111111111111111111111111111111111111111111
100000000000100012090920100000761060001050001000001
101111111110121010101119101111101011101111101010111
100010096210101010101090100010101510550000901010001
111010111110111010101110111010101011111111171211191
100010100020100010100010007017121000900010061010001
101110101111191110111011111110101011111011111910111
101000921000100000100010770010090000107060560010001
101011111915111011101112111010111111101110111111101
101500260010901000101009101000100600001005100510101
101111111111101111101010101111111011111011101610101
101009060016101000151009050290051010601010001005101
101210111010101010101110111111101012101010101111171
101012001000105010106010100510001000101015101060091
101111101111111110111012101510101011101010101011101
101000100060502020126015201019001010157010101610161
101010111010101111151110101911101210111110101010151
100010001010101060001006101000101010000000101010101
100001191110101112111010101110101010111112111010191
100300150010121020109510100010621006101000106010901
100000111010101011161111111011111111101011101110111
100010002010100010100600006000021000001000091000061
101010111110111110101112111111101110111015111011111
151010001010001050001012100000161000120015001510001
101011101010101011111010101110151511101111171110101
121000101610109010006610100010001090600510120016101
101011101010111111101110111611111111111510111010101
101010021010100020101005101012000070150010000502101
161010111016101110101010101010111610101110151111101
101010100000601060051516001019106010100000100010021
101110111110111111111011101011121110111110111110191
101000100010100000261000000010901610051000100000101
101011101011101111101110111110111011101000001111101
101000001000001900100010109000100010001004000500161
101111111111111011111010111211101110111100011110161
100500000000500000200210000017005070000000000000101
111111111111111111111111111111111111111111111111111
111111111111111111111111111111111111111111111111111
