1,1,1,1,1,1,1,1,1,1,1,1,1,1,1,1,1,1,1,1,1,1,1,1,1,1,1,1,1,1,1,1,1,1,1,1,1,1,1,1,1,1,1,1,1,1,1,1,1,1,1
1,0,0,0,0,0,0,1,1,0,0,0,0,0,0,0,0,0,0,0,0,0,0,0,0,0,0,1,1,0,0,0,0,0,0,1,1,2,0,0,0,0,0,0,0,0,0,0,0,9,1
1,9,0,0,0,0,0,1,1,0,0,0,0,0,0,9,0,6,0,0,0,0,0,0,0,0,0,1,1,0,0,0,0,0,0,1,1,0,6,0,0,0,0,0,0,9,9,0,0,0,1
1,0,0,1,1,0,0,1,1,0,0,1,1,0,0,1,1,1,1,1,1,1,1,1,1,0,0,1,1,0,0,1,1,0,0,1,1,0,5,1,1,1,1,1,1,1,1,0,2,0,1
1,0,0,1,1,0,0,1,1,0,0,1,1,0,0,1,1,1,1,1,1,1,1,1,1,0,0,1,1,0,0,1,1,0,0,1,1,0,0,1,1,1,1,1,1,1,1,0,0,0,1
1,0,0,1,1,0,0,1,1,0,0,1,1,0,0,9,6,0,0,1,1,0,0,1,1,0,0,0,0,0,0,1,1,0,0,1,1,9,0,1,1,0,6,2,0,0,0,0,0,0,1
1,0,0,1,1,0,0,1,1,0,0,1,1,0,2,0,0,9,0,1,1,0,0,1,1,0,0,0,0,0,0,1,1,0,0,1,1,0,0,1,1,2,0,0,0,0,0,10,11,0,1
1,0,0,1,1,0,0,1,1,0,0,1,1,1,1,1,1,0,0,1,1,0,0,1,1,1,1,1,1,1,1,1,1,0,0,1,1,0,0,1,1,0,0,1,1,0,0,12,13,0,1
1,0,0,1,1,6,2,1,1,0,2,1,1,1,1,1,1,0,0,1,1,0,0,1,1,1,1,1,1,1,1,1,1,0,0,1,1,0,0,1,1,0,0,1,1,0,0,14,15,0,1
1,0,0,1,1,0,0,0,0,0,0,1,1,0,0,0,0,0,0,1,1,0,0,0,2,0,0,9,0,0,0,1,1,0,0,1,1,0,0,1,1,0,0,1,1,2,0,0,0,0,1
1,0,0,1,1,6,0,0,0,0,0,1,1,0,2,0,0,0,0,1,1,5,0,9,0,5,0,0,0,0,6,1,1,0,0,1,1,0,0,1,1,0,0,1,1,0,0,0,6,0,1
1,1,1,1,1,1,1,1,1,1,1,1,1,0,0,1,1,1,1,1,1,1,1,1,1,0,0,1,1,0,7,1,1,0,0,1,1,0,0,1,1,0,0,1,1,2,0,0,0,0,1
1,1,1,1,1,1,1,1,1,1,1,1,1,6,0,1,1,1,1,1,1,1,1,1,1,0,0,1,1,0,0,1,1,0,6,1,1,0,0,1,1,0,0,1,1,0,0,0,0,0,1
1,0,0,0,0,0,0,0,0,0,3,0,0,0,0,1,1,0,0,0,0,0,0,0,0,0,0,1,1,0,0,1,1,0,0,1,1,9,0,0,9,0,6,1,1,9,7,0,9,0,1
1,0,0,9,0,0,0,0,0,7,0,0,0,6,0,1,1,5,0,5,2,0,0,0,0,0,0,1,1,0,0,1,1,0,7,1,1,0,0,0,0,0,0,1,1,0,9,0,0,0,1
1,0,0,1,1,1,1,1,1,1,1,1,1,1,1,1,1,0,0,1,1,1,1,1,1,1,1,1,1,1,1,1,1,0,0,1,1,0,9,1,1,1,1,1,1,0,0,0,0,0,1
1,0,0,1,1,1,1,1,1,1,1,1,1,1,1,1,1,0,0,1,1,1,1,1,1,1,1,1,1,1,1,1,1,0,0,1,1,0,0,1,1,1,1,1,1,0,10,11,0,0,1
1,0,0,0,0,0,0,0,1,0,0,0,0,0,0,0,0,0,2,1,1,0,0,0,0,0,0,0,0,0,0,0,0,0,6,1,1,6,9,1,1,2,0,0,0,0,12,13,0,0,1
1,0,5,0,0,0,0,0,0,0,0,0,0,0,0,0,0,0,0,1,1,2,0,2,0,0,9,0,0,0,0,9,0,0,0,1,1,0,0,1,1,0,0,0,0,0,14,15,0,0,1
1,1,1,0,0,0,0,0,0,0,9,1,1,2,0,1,1,1,1,1,1,0,0,1,1,1,1,1,1,1,1,1,1,1,1,1,1,1,1,1,1,0,0,1,1,1,1,1,0,0,1
1,1,1,1,1,1,1,1,1,0,0,1,1,0,0,1,1,1,1,1,1,0,0,1,1,1,1,1,1,1,1,1,1,1,1,1,1,1,1,1,1,0,0,1,1,1,1,1,0,0,1
1,0,0,0,0,0,0,0,0,0,5,1,1,0,2,0,9,0,9,1,1,0,0,1,1,0,0,0,9,0,5,0,0,0,0,0,0,0,0,1,1,2,0,0,0,0,0,1,6,0,1
1,0,0,0,0,0,0,0,0,0,0,1,1,0,6,0,0,0,0,1,1,0,0,1,1,0,0,0,5,0,0,0,9,2,0,0,0,0,2,1,1,0,0,2,0,0,0,1,0,0,1
1,0,0,1,1,1,1,1,1,1,1,1,1,1,1,1,1,0,0,1,1,0,0,1,1,1,1,1,1,0,0,1,1,1,1,1,1,0,0,1,1,1,1,1,1,0,0,1,0,0,1
1,0,0,1,1,1,1,1,1,1,1,1,1,1,1,1,1,0,0,1,1,0,0,1,1,1,1,1,1,0,0,1,1,1,1,1,1,0,0,1,1,1,1,1,1,0,0,1,0,9,1
1,0,0,1,1,0,0,0,0,0,0,0,0,0,7,1,1,6,0,1,1,0,0,0,0,0,0,1,1,9,0,1,1,0,0,1,1,0,0,0,0,0,0,1,1,0,0,1,1,1,1
1,0,0,1,1,0,0,0,7,0,0,0,0,0,0,1,1,0,0,1,1,0,0,0,5,0,0,1,1,9,0,1,1,6,0,1,1,0,0,6,0,0,0,1,1,0,0,1,1,1,1
1,0,0,1,1,7,0,1,1,1,1,1,1,6,0,1,1,5,0,1,1,1,1,1,1,0,0,1,1,0,6,1,1,0,0,1,1,1,1,1,1,0,0,1,1,0,0,0,10,11,1
1,0,0,1,1,0,0,1,1,1,1,1,1,0,0,1,1,2,0,1,1,1,1,1,1,0,6,1,1,9,0,1,1,0,0,1,1,1,1,1,1,0,0,1,1,5,0,0,12,13,1
1,0,0,1,1,0,0,1,1,0,0,0,0,0,0,1,1,0,0,0,0,0,2,1,1,0,0,0,0,0,0,1,1,0,0,0,0,0,0,1,1,0,0,0,0,0,0,0,14,15,1
1,0,0,1,1,4,0,1,1,0,0,0,0,6,0,1,1,0,0,0,0,0,0,1,1,6,0,0,0,0,2,1,1,0,0,0,2,0,0,1,1,0,0,6,0,0,2,0,0,0,1
1,0,0,1,1,0,0,1,1,0,0,1,1,9,0,1,1,0,0,1,1,1,1,1,1,1,1,1,1,1,1,1,1,0,0,1,1,0,0,1,1,1,1,1,1,0,0,0,0,0,1
1,0,0,1,1,1,1,1,1,0,0,1,1,0,0,1,1,0,5,1,1,1,1,1,1,1,1,1,1,1,1,1,1,0,6,1,1,0,0,1,1,1,1,1,1,0,5,0,7,0,1
1,0,0,6,0,0,0,0,0,0,0,1,1,0,9,1,1,0,0,6,7,0,0,0,0,0,0,0,0,2,0,0,0,0,9,1,1,0,0,0,0,0,5,0,0,0,0,0,0,0,1
1,10,11,0,0,0,6,0,9,2,0,1,1,0,0,1,1,0,0,0,0,0,10,11,0,9,0,0,0,0,6,0,0,0,0,1,1,10,11,0,0,0,2,0,0,5,0,0,10,11,1
1,12,13,0,2,0,0,0,0,0,0,1,1,0,0,0,0,0,2,0,1,1,12,13,0,0,2,0,0,0,0,0,0,6,0,1,1,12,13,0,9,0,0,0,0,0,0,0,12,13,1
1,14,15,0,0,0,9,0,0,0,0,1,1,0,0,0,0,9,0,0,1,1,14,15,9,6,0,0,2,0,7,0,0,0,9,1,1,14,15,6,0,0,0,0,9,0,0,0,14,15,1
1,1,1,1,1,1,1,1,1,1,1,1,1,1,1,1,1,1,1,1,1,1,1,1,1,1,1,1,1,1,1,1,1,1,1,1,1,1,1,1,1,1,1,1,1,1,1,1,1,1,1
